11111111111111111111111111111111111111111
1P00001000001C0000000000000000001C0000001
10111010101011101011111111111110111110111
10001000101000001010000000000010000010001
11101111101111111010111111111011111011101
1C0000100010000010100010000000100E1000001
11111110101011101011101011111110111111101
1000001010101C101C10001010000C10000000001
10111010101010101110111010111110111111101
10001000101000100000100010000000100000101
10101111101110111111101111111110101110101
101010001000100000001000000000101000101C1
10101010111011111110111111111011111010111
10100010001C100000100000000C10000C1010001
10111111101110101111111110111110111011101
10000000100000100000000010100010000010001
11101111111110111111111010101011111110101
1C10100000001C100010001000101000100010101
10101011111011101010101111101110101010101
100010000C10000010001000000010000010001C1
11111111111111111111111111111111111111111